32 18
00000000000000000000000000000000
00000000000000000000000000000000
00000000000000000000000000000000
00000000000000000000000000000000
00008aa9000000000000000000000000
00000000000000000000000000000000
00000000000016200000000000000000
0000000000000000000000000000000b
00000000000000000016620000000163
00000000000000000000000000001333
00000000000000000000000000013333
00000000000000000000000000133333
00000000000000000000000016333333
00000000000000000000001633333333
00000000000000000016667333333733
00000000000000016633733333733333
8aaaaaaaaaaaaaa33373333333333333
43333373333333333373333337333335
